11111111111
1P00100C1E1
11100010001
11C01111111
11111111111