1111111
10000P1
100C001
100E001
1111111