11111111
100010C1
1P1C00E1
11111111