11111111
10P010C1
101C00E1
11111111